______________________________________________________________________________________________________________________
______________________________________________________________________________________________________________________
______________________________________________________________________________________________________________________
______________________________________________________________________________________________________________________
______________________________________________________________________________________________________________________
______________________________________________________________________________________________________________________
______________________________________________________________________________________________________________________
______________________________________________________________________________________________________________________
______________________________________________________________________________________________________________________
______________________________________________________________________________________________________________________
______________________________________________________________________________________________________________________
______________________________________________________________________________________________________________________
______________________________________________________________________________________________________________________
______________________________________________________________________________________________________________________
______________________________________________________________________________________________________________________
______________________________________________________________________________________________________________________
______________________________________________________________________________________________________________________
______________________________________________________________________________________________________________________
______________________________________________________________________________________________________________________
______________________________________________________________________________________________________________________
________________________________________________________________________________________1111111111____________________
_______________________________________________________________________________________11222222221____________________
______________________________________________________________________________________112233333321____________________
_____________________________________________________________________________________1122333333321____________________
____________________________________________________________________________________11223333333321____________________
_1111111111111111111111____________________________________________________________112233333333321____________________
_1333333333333333333331___________________________________________________________1122333333333321____________________
_1111111111111111111111_______11111111111111111111111111111111111111111111111111111223333333333321____________________
______________________________12222222222222222222222222222222222222222222222222222233333333333321____________________
______________________________12333333333333333333333333333333333333333333333333333333333333333321____________________
______________________________12333333333333333333333333333333333333333333333333333333333333333321____________________
______________________________12333333333333333333333333333333333333333333333333333333333333333321____________________
______________________________12333333333333333333333333333333333333333333333333333333333333333321____________________
______________________________12333333333333333333333333333333333333333333333333333333333333333321____________________
______________________________12333333333333333333333333333333333333333333333333333333333333333321____________________
______________________________12333333333333333333333333333333333333333333333333333333333333333321____________________
______________________________12333333333333333333333333333333333333333333333333333333333333333321____________________
______________________________12222222222222222222222222222222222222222222222222222222222222222221____________________
______________________________11111111111111111111111111111111111111111111111111111111111111111111____________________
______________________________________________________________________________________________________________________
______________________________________________________________________________________________________________________