00000000000000000000000000000000000000000000000000000000000000000000000000000000000000000
00000000000000000000000000000000000000000000000000000000000000000000000000000000000000000
00000000000000000000000000000000000000000000000000000000000000000000000000000000000000000
00000000000000000000000000000000000000000000000000000000000000000000000000000000000000000
00000000000000000000000000000000000000000000000000000000000000000000000000000000000000000
81111111111111112000000000000000000000000000000000000000000000000000000000000000000000000
799999999999c5554000000000000000000000000000000000000000000000000000000000000000000000000
79999999999c40000000008111111111111111111111111200000000000000000000000000000000000000000
7999999999c400000000006555555555555555555555555400000008111200000000000000000000000000000
799999999c400000000000000000000000000000000000000000000799c400000000000000000000000000000
79999999c400000000000000000000000000000000000000000000079c4000000000000000000000000000000
7999999c400000000000000000000000000000000000000000000007c40000000000000000000000000000000
799999c4000000000000000000000000000000000000000000000006400000000000000000000000000000000
79999930000000000000000000000000000000000000000000000000000000000000000000000000000000000
79999930000000000000000000000000000000000000000000000000000000000081111111112000000000000
799999300000000000000000000000000000000000000000000000000000000008a9999999993000000000000
79999930000000000000000000000000000000000000000000000000000000008a99999999993000000000000
7999993000000000000000000000000000000000000000000000000000000008a999999999993000000000000
799999300000000000000000000000000000000000000000000000000000008a9999999999993000000000000
79999930000000000000000000000000000000000000000000000000000008a99999999999993000000000000
7999993000000000000000000000000000000000000000000000000000008a999999999999993000000000000
799999300000000000000000000000000000000000000000000000000008a9999999999999993000000000000
799999b2000000000000000000000000000000000000000000000000008a99999999999999993000000000000
7999999b20000000000000000000000000000000000000000000000008a999999999999999993000000000000
79999999b200000000000000000000000000000000000000000000008a9999999999999999993000000000000
799999999b1111111111111111111111111111111111111111111111a99999999999999999993000000000000
7999999999999999999999999999999999999999999999999999999999999999999999999999300000000000
7999999999999999999999999999999999999999999999999999999999999999999999999999300000000000
6555555555555555555555555555555555555555555555555555555555555555555555555555400000000000