______________________________________________________________________________________________________________________
______________________________________________________________________________________________________________________
______________________________________________________________________________________________________________________
______________________________________________________________________________________________________________________
______________________________________________________________________________________________________________________
______________________________________________________________________________________________________________________
______________________________________________________________________________________________________________________
______________________________________________________________________________________________________________________
______________________________________________________________________________________________________________________
______________________________________________________________________________________________________________________
______________________________________________________________________________________________________________________
______________________________________________________________________________________________________________________
______________________________________________________________________________________________________________________
______________________________________________________________________________________________________________________
______________________________________________________________________________________________________________________
______________________________________________________________________________________________________________________
______________________________________________________________________________________________________________________
______________________________________________________________________________________________________________________
______________________________________________________________________________________________________________________
____________________________________________________________111111111111111111111_____________________________________
____________________________________________________________133333333333333333331_____________________________________
____________________________________________________________111111111111111111111_____________________________________
______________________________________________________________________________________________________________________
______________________________________________________________________________________________________________________
________________________________________________________________________________________1111111111____________________
_______________________________________________________________________________________13333333331____________________
______________________________________________________________________________________133333333331____________________
_____________________________________________________________________________________1333333333331____________________
____________________________________________________________________________________13333333333331____________________
_1111111111111111111111____________________________________________________________133333333333331____________________
_1333333333333333333331___________________________________________________________1333333333333331____________________
_1111111111111111111111_______11111111111111111111111111111111111111111111111111113333333333333331____________________
______________________________13333333333333333333333333333333333333333333333333333333333333333331____________________
______________________________13333333333333333333333333333333333333333333333333333333333333333331____________________
______________________________13333333333333333333333333333333333333333333333333333333333333333331____________________
______________________________13333333333333333333333333333333333333333333333333333333333333333331____________________
______________________________13333333333333333333333333333333333333333333333333333333333333333331____________________
______________________________13333333333333333333333333333333333333333333333333333333333333333331____________________
______________________________13333333333333333333333333333333333333333333333333333333333333333331____________________
______________________________13333333333333333333333333333333333333333333333333333333333333333331____________________
______________________________13333333333333333333333333333333333333333333333333333333333333333331____________________
______________________________13333333333333333333333333333333333333333333333333333333333333333331____________________
______________________________11111111111111111111111111111111111111111111111111111111111111111111____________________
______________________________________________________________________________________________________________________
______________________________________________________________________________________________________________________
